+--+--+--+--+
|p   b      |
+  +--+  +  +
|  |     |  |
+  +  +--+--+
|  |     b  |
+  +--+--+  +
|   b    | g|
+--+--+--+--+