+--+--+--+--+
|p   V      |
+  +--+  +  +
|  |   |V | |
+  +  +--+  +
| V   |     |
+--+  +--+  +
|  V  |     |
+  +--+--+  +
|      V |  |
+--+  +--+  +
|   |   |  g|
+--+--+--+--+